Chicklits
Turbo mama – Melanie la Brooy
Pas op mijn dochter – Louise Candlish
Wegwezen – Sheila O’Flanagan
Moeder gaat op stap – Sheila gaat op stap
Nu of nooit – Marian Keyes
Zoals ze is – Marian Keyes
Plaza Granada – Victoria Hislop
Verloren zusje, Missie voor een moeder – Rita Herron
Ierse Honing – Victoria Clayton
Laat mij maar even – Jennifer Crusie
Gek op jou? – Jennifer Crusie
Ik weet dat je er bent – Laura Brodie
Bella – Leslie Pearse
Chanel chic – Laura Weisenberger
Mijn zonnestraaltje – Denise Deegan
Het geheime van een ploetermoeder – Fiona Neill
Shopaholic grijpt in – Sophia Kinsella
Wedden van wel – Alisa Kwitney
Alleen naar bed – Jennifer Weiner
Iemand als jij – Cathy Kelly
De boot gemist – Jill Mansell
Scherven brengen geluk – Jill Mansell
Hotm@il – Jessica Adams
Zwaar verliefd – Chantal van Gastel
Geknipt voor jou – Chantal van Gastel
Zoete wraak – Anna Maxted
Dagboek van een hofdame – Sarah Goodall &Nicholas Monson
Zus enzo – Anna Maxted
Vergeet het maar – Melissa Nathan
Supermoeder – Sarah Bilston
De babyplanner – Barbara Muller
Heb je mij nog lief? – Josie Loyd&Emlyn Rees
Was het een droom? – Torey Hayden
Champagne in chateau Marmont – Lauren Westenberger
De wraak van prada – Lauren Weisberger
Bewogen vrouwenslevens – Quarda Saillo