Engels
Now you can read – first readers
The rupert annual – pedigree
Thea Stilton and the mystery in Paris – Jeronimo Stilton
1000 words – disney learning
Totally crushed – Eliza Willard
Harry Potter – J.K.Rowling
Little book of proverbs – Dean Walley
Thumb wrestling –
Jolly dictionary – Sata Wemham ans Sue Lloyd
Romeo and julliet – shakespeare
The comfort of strangers – Ian mc Ewan
Gorillas in the mist – Dian Fossey
Bride flight – Marieke van der Pol
State of fear – Michael crichton
Light in the shadows – Edie Hartshorne
Bad company – Jack Higgins
Taken – Kathleen George
Hong Kong – Stephen Coonts
Elizabeth’s Women – Tracy Borman
Hitte – James Patterson
Chesapeake – James A.Michener
Self matters – Dr. Phil Mc Graw
Peace kills – P.J.O’Rourke
The day of the jackal/the dogs of war – Frederik Forsyth
The girl in the spider’s web – David Lagercrantz
Artemis fowl – Eoin Colfer’s
The scarlet letter and other tales – Nathaniel Hawthorne
Canada – Richard Ford
Mirror Image – Danielle Steel
All the grey cats – Craig Thomas
The spirit to serve – J.W.Marriott e.a.
Whats the ceo wants you to know – Ram Charan
Conception, pregnancy and birth – Dr. Miriam Stoppard
The usborne yummy little cookbook –
What matters most – Hyrum W.Smith
Mr stone en het riddergenootschap – V.S.Naipaul
Pacific rising – Simon Winchester
Action urgency excellence – Ram Charan
The interruption of everything – Terry Mc Millan
A widow for one year – John Irving
Etrangers dans la nuit – Marc Lambron
The world according to clarkson – Jeremy Clarkson
The hutchinson encyclopedie  1998 –
Psychology – Bernstein e.a.
Twilight of princes – milestones of history
The fires of faith – milestones of history
Meet mw at the cupcake café – Jenny Colgan
Treasures from the kremlin  –
Travellers wine guide – Germany – Dr Hans Ambrosi
David Bowie – the last interview
George W. Bushisms –
The bride and the bachelors – Calvin Tomkins
Tony&ik – George Bush
Europe for free – Brian Butler
Exo-Vaticana – Cris Putnam e.a.
The war on freedom – Ahmed
The discovery of france – Graham Robb
The barn dance – james F.Twyman
The letters and diaries of Oskar Schlemmer – Tut Schlemmer
Chivalry – medieval wishdom
The tapping solution – Nick Ortner
The Natural – Bernard Malamud
War and peace – tolstoy
A guid to autism – C.A.Hart
Extremely loud&incredibly close – Jonathan Safran Foer
I virgil – David Wilshart
Sons and lovers – D.H.Lawrence
Lady chatterley’s lover – D.H.Lawrence
Plaines tales from the hills – Rudyard Kipling
Anna karenin – Tolstoy
I, claudius – Robert Graves
The Alexender trilogy – Mary Renault
The unlikely pilgrimage of Harold fry – Rachel Joyce
A fathers&his fate – Ivy Compton-Burnett
The turkish embassy letters – Lady Mary Wortley Montagu
Buying a fishing – Gao Xingjian
The way the crow flies – A. MacDonald
Extremely loud&incredibly close – J.Safran Foer
Everithing is iluminated – J.Safran Foer
Beastly tales – Vikram Seth
Bad blood – Lorna Sage
The garden party – Katherine Mansfield
The corrections – Jonathan Franzen
Temples of delight – Barbara Trapido
Clara Callan – R.Wright
The country wife – W.Wycherley
Devils cub – G.Heyer
No great mischief – A.McLeod
The prisoner of zenda – A.Hope
1314 and all that – S.Anderson
The last english king – J.Rathbone
Macbeth – Shakespeare
Claudius the God – R.Graves
Pamela – S.Richardson
The man who mistook his wife for a hat – Oliver Sacks
Brick lane – Monica Ali
Flaubert’s parrot – Julian Barnes
The national short story prize 2006 –
King – Willam Shakespeare
A heartbreaking work of staggering genius – Dave Eggers
‘Tis – Frank McCourt
The Magus – John Fowles
As you like it – Shakespeare
The nose – Elena Lappin
Cake and Ale or the skeleton – W.Somerset Maugham
Lincoln in the bardo – George Saunders
Anything is possible – Elizabeth Strouth
Islands – Dan Sleigh
The return of Ulysses – Edith Hall
The last of the savages – Jay McInerney