Kinderboeken - 8+
De club van 7 en het kasteel – Enid Blyton
De geheime club van 7 – Enid Blyton
De club van 7 vecht terug – Enid Blyton
De club van 7 - De vijf in een kampeerwagen – Enid Blyton
De club van 7 en de pareldief – Enid Blyton
500 megaleuke moppen voor kinderen –
De sprookjesspeurders – Marcel van Driel (groep 6)
Het kleine mannetje – Martin Ebbertz
FC Oostwijk – in de aanval – Jaap-Wim van der Horst
Wiplala weer – Annie M.G.Schmid
Je bent super Jan – Harmen van Straaten
Blauwe plekken – Anke de Vries
Wat rijmt er op purre – edward van de Vendel, 2x
De eilanden ruzie – Jozua Douglas
Kalouha Dzong – Lydia Rood
Eiber – Sjoerd Kuyper
Ik ben Polleke hoor – Guus Kuijer
Voor één dag maar – Manfred Man
Per ongelukt@ – Simon van der Geest
De kleine krijger – Marion Bloem
Laika tussen de sterren – Bibi Dumon Tak
De wraak van het spruitje – Jan Paul Schutten
Wonderkinderen – Thea Beckman
Marloes – Henk Hokke
Boris en het woeste water – Rindert Kromhout
Maliff en de wolf – Hans Hagen (avi 6)
Goal – Vivian den Hollander (avi 6)
Alleen maar voetbal – Kirsten Boie (avi 6)
Buitenspel – Vivian den Hollander (avi 7)
Kaatje knal en de biefstukbende – Carry Slee (avi 7)
Straatkatten – Mieke van Hooft (avi 7)
Giechelig op school – Ingrid Uebe (avi 7)
Grieselstate – Anthony Horowitz (avi 8)
De dans van de paarden – Peter Vervloed
Het geheim van de verliefde hulpkok – Jacques Vriens (avi 8)
De eilandenruzie – Jozua Douglas
Juffertje Tim – Paul Biegel (avi 8)
Kinderen ontvoerd – Mieke van Hooft (avi 8)
Jubeltenen – Rita Verschuur (avi 8)
Witte heksenmarkt – Marc de Bel (avi 8)
Weg met de meester – Miek van Hooft (avi 8)
Willem is een weerwolf – Hermine Landvreugd (avi 8)
Wij zijn wegkinderen – Thea Beckman (avi 9)
Briefgeheim – Jan Terlouw (avi 9)
Pizza pikante – Mirjam Oldenhave
Suske en Wiske – de Jokkende joker
Katrien Duck – pocket 4