Psychologisch
Op de drempel van de dood – Jean Ritchie
Van adam tot de zevende hemel – Ella van ’t Hof
Alchemie van de liefde – Lisette Thooft
Braintraining – Sirene
Wanneer het mis gaat in je hoofd – Pieter Webeling
Humanisme – Ton Vink
Als jou leven een cirkel is waar sta je dan – Inez van Oord
The mindgym –
Vitaal zonder angst – Roy Martin
Schuldgevoel – Coen Simon
Vanuit het hart gesproken – Eddie&Debbie Shapiro
De dolfijn in ieder van ons – Olivia de Bergerac
Bekend met kanker – Willemijn van Benthem
(geluks)steentje, grote steun in het leven – James Wanless Ph.D.
Balans, 138 tips voor meer energie en minder stress – Goedele Leyssen
Transcedentaal ervaren – Karlfried Graf Dürkheim
Body stress release – Edith Wiersma-Arts
Verborgen gevoelens – Christ Zois
Dromen, visioenen en uittredingen – André Groote
Kabbala, wijsheid en adviezen van de boom des levens – Shoshanna Cohen
Van zorgenkind tot medium – Robbert ten Broeke
Vuurkoord van het heimwee – Pieter van Exter
Van ziel tot ziel – Gary Zukav
Innerlijke kracht – Char
Test Jezelf – Strengholt
Omgaan met verlies – Roger Rundqvist
Vrijheid in ballingsschap, autobiografie dalai lama – Tenzin Gyatso
Leven kun je leren – dr Martin Boot
Barsten zonder te breken (loslaten in meditatie en psychotherapie – Mark Epstein
Melancholie – Dorthe Binkert
Reiki als ambacht – Fons Delnooz & Patricia Martinot
Magnetiseren, wat is dat? – Frank den Ouden
Horoscoop van de menselijke relaties – Linda Goodman
Ontspannings- en meditatietechnieken – Leon Chaitow
Meditatie voor beginners – Stephanie Clement
Geen zee te hoog – Dr Wayne Dyer
Vriendelijkheid en helder in inzicht – De dalai lama
Char, het medium – Char Margolis
Psychologische boeken – G.Jowett
De tao van fysica – fridjof capra
De oplosbare vis en andere paradoxen – s.ortoli en j.p pharabod
The big five for live – vervul je 5 grote levenswensen – J.Strelecky
Waarom mannen niet luisteren – Allan&Barbara Pease
De daemon, ons hogere zelf – Anthony Peake
Stap voor stap van wens naar werkelijkheid – Geert Kimpen
Het retorische antwoord – Engbersen e.a.
Het voelen gevoed – Margo Knapen
Hoogbegaafd, wat betekent dat – Karel Jurgens
Veld van overvloed – Louise Dekker
Het puberende brein – Eveline Kroon
Volg je hart – Dalai Lama
Kijken in de spiegel – Krishnamurti
Krishnamurti in Ommen – Siem van Eeten e.a.
Eenvoudige oefeningen voor meer rust en energie – Qi Gong
Het nieuwe grote heksenboek – Laurie Chabot
De heksenketel – Kate West
Het boeken der schaduwen (heksen) – Phyllis Curott
Heksenkunsten – Phyllis Curott
Het grote heksenboek – Laurie Chabot
Dementie op jonge leeftijd – Janssens/v.d. Vugt
Hoera, ik ben hoogbegaafd – Marga Schouten
Greep op de overgang – Georgie Dom
Suikers, schimmels en allergie – Anna Kruyswijk-van der Heijden
Een gezonde rug – Dieter Dorn
Uit de ban van je fobie – cor anneese/tino pol
De man die zijn vrouw voor een hoed hield – oliver sacks
Een been om op te staan – oliver sacks
De paardenjongen – Rupert Isaacson (autisme)
Een vreemde wereld – Martine F.Delfos (autisme)
Normaal begaafde autistische kinderen – Anne Vibeke Fleischer
Het land ritalin – Elizabeth Wurtzel
Oudergids aspergersyndroom – Brenda Boyd
Allemaal psychisch – Piet Vroon